1111111111111111
1010000000001001
1001000000010001
1000101000100001
1000000000000001
1000000000000001
1000000000000001
1000000000000001
1000000000000001
1000000111111001
1000000100000001
1000000101111001
1000100101000001
1000000101000001
1000000101000001
1111111111111111