11111111
10000001
11111001
    10011111
    10000001
    11111111